########
#..#...#
#.oxxo.#
#@ox..##
#.oxxo.#
#..#...#
########