###############
#.............#
#.............#
#.............#
#.......x.....#
#.......o.....#
#.....ox@..xo.#
#.......x.....#
#.............#
#.......o.....#
#.............#
###############
