#########
#.......#
#.o..#x##
#.#~o...#
#..@..x.#
#########