##########
#x.......#
#....o...#
#...~~...#
#......o.#
#.. .@...#
##########