###############
#.............#
#~.o..........#
#........oo...#
#..o....xo....#
#.......o.....#
#..o..ox@.xxo.#
#.......xxx...#
#.............#
#.......o.....#
#.............#
###############
