##########
#........#
#..O.....#
#..X.X...#
#.O..O...#
#....@...#
##########