#######
#.....#
#..X..#
#.....#
#.....####
#.....O@.#
#........#
##########