#####
#.@.#
#X#.#
#.O.#
#...#
#####