#####
#...#
#.X.#
#XO@#
#...#
#####