######
#.@..##
#..~..#
#..O..#
##...##
 ##### 