##########
#........#
#....X...#
#...XX...#
#..O.O...#
#........#
#....@...#
#........#
#.......X#
##########