#####
#...#
#...#
#.@.#
#...#
#####