###############
#.............#
#.............#
#.............#
#.......X.....#
#.......O.....#
#.....OX@..X.O#
#.......X.....#
#.............#
#.......O.....#
#.............#
###############
