##########
#........#
#........#
#..OX....#
#........#
#..~.....#
#....@...#
#........#
#.......X#
##########