#############
#.......#..x#
#.O..#X##..##
#.#.O~..O...#
#..@.~X.##.##
#..#.~......#
#############