##########
#X.......#
#........#
#...~~~..#
#....O...#
#.. .@...#
###..#####
          
          
          
          