######
##...#
#.o..#
#@.#x#
######