#######
#..$..#
#.O.O.#
#X.X..#
# .@..#
#######