#######
#xo..x#
#..x..#
####o.#
#..#..####
#@o#.o...#
#...x....#
##########