########
#..#...#
#.OXXO.#
#@OX..##
#.OXXO.#
#..#...#
########