######
#...x#
#.o###
#...@#
######