#######
#..@..#
#..XOs.#
#..O..#
#X....####
#...O....#
#.X......#
##########