######
##...#
#.O..#
#..@X....#
######