##########
#X.......#
#....O...#
#...~~...#
#......O.#
#.. .@...#
##########