#####
#..X~~..#
#.~.~...~~.#
#~..~.~..~~~#
#.~.~~....~~~~#
#.X.~.~..~...~~.~.~~.~~#
#.O..~...~#
#.@.~..~.#
#.~.~....#
#..~..#
####.#