##########
#X.......#
#....O...#
#....X...#
#....O...#
#.. .@...#
###..#####
          
          
          
          