######
##...#
#.O..#
#..@X#
######