##########
#........#
#.OX..XO.#
#..X..X..#
#..O..O..#
#....@...#
##########