######
##...#
#.O..#
#@.#X#
######