#######
#..$..#
#.O.O.#
#X.X..#
#..@..#
#######