#######
#..@....#
#..O....#
#..X....#
#XO......####
#.O.OX...#
#.X......#
##########