###########
#@........#
#.O.......#
#......X..#
#.........#
###########
