#######
#..$..#
#.O.O.#
#..X..#
#..@..#
#######